attribution - przypisywanie
hamper - hamować / przeszkadzać
recounted - szczegółowo opowiadać
empowered - upoważniony / władny
vaster - obszerny / ogromny / nieprzebrany
frivolous - frywolny / niepoważny / błahy
sublime - wzniosły / najwyższy
revel - ucztować / biesiadować
soar - rosnąć / wzrastać / unosić się
shed light - rzucać światło
testimony - zeznania / świadectwo
exhilarating - porywający / ekscytujący
outline - zarys / kontur
emerge - wyłaniać się / ukazywać się
infancy - stadium początkowe / wczesne dzieciństwo / niemowlęctwo
dreamwork - proces związany z nieświadomymi myślami przenikającymi do snów
manifest - jawny / oczywisty / objawić się
conceal - ukryć / skryć
curriculum - program nauczania
enrich - wzbogacić
excerpt - wyjątek / ustęp / fragment np książki / wybierać wyjątek/ustęp/fragment
anegdota - krótka i zabawna historia z życia
invaluable - nieoceniony / bezcenny
inducing - wywoływać
strives - usiłować / starać się / walczyć / dążyć
manner - sposób
plainly - wyraźnie / jasno / otwarcie
spelled out - przedstawione / wyjaśnione / w pełnej formie
diligently - pilnie / starannie
relevant - znaczący / istotny / odpowiedni
application - zastosowanie / użycie
devoted - poświęcony / oddany
kompendium - dzieło zawierające zbiór podstawowych informacji z pewnej dziedziny
antologia - zbiór utworów powiązanych ze sobą tematyką
encyklopedia - kompendium wiedzy złożone z haseł i ich wyjaśnień
model - zaprezentować
skimming - przebiegać wzrokiem / muskać
prerequsite - warunek wstępny / wymóg
sufficient - wystarczający / dostateczny
persevere - wytrwać / trwać
proficiency - wprawa / biegłość / kompetencja
reservation - zastrzeżenie
inhibit - hamować / utrudniać / zabraniać
get acquainted - zaznajomić się
recall - przypomnieć sobie / pamięć
induction - wprowadzenie / prowokowanie / indukowanie
signpost - drogowskaz
from within - od wewnątrz / ze środka
background - przygotowanie / kontekst / środowisko
inherent - nieodłączny / przyrodzony
enact - odgrywać / grać / wcielać w życie
deepened - pogłębiony
diverse - różnorodny / rozmaity / zróżnicowane
ihibitions - zahamowania
in so doing - w ten sposób / robiąc tak / przez takie działanie
integrated - zintegrowane / scalone
unheard - niesłyszalne / niesłychane
thereby - wskutek czego / tym samym / w ten sposób
cope with - radzić sobie
intimations - oznaka / ogłoszenie / zawiadomienie
attain - zdobywać / osiągać / realizować
extent - zakres / zasięg / stopień
justify - usprawiedliwiać
read on - kontynuuj czytanie
proverbially - przysłowiowo
virtually - praktycznie / niemalże
store - zapas / skład
lifespan - czas trwania życia / żywotność / trwałość
enjoyment - radość / przyjemność / korzystanie
lucidyty - jasność / przytomność umysłu
reservoir - rezerwuar / zbiornik / zapas
overlooked - przeoczone / pominięte / przymknąć oko / patrzyć z góry
move about - poruszać się / przemieszczać się / kręcić się (o chodzeniu) / przenosić się
delight - wielka przyjemność / zachwyt
notion - myśl / pogląd / wyobrażenie / pojęcie
blissful - błogi / rozkoszny
float - platforma / unosić / dryfować
persist - utrzymywać / nie ustępować / nalegać
carry-over - skutek dawnych działań / pozostałość
color - pokolorwać / koloryzować / rzutować na coś
uplift - podniesienie na duchu / otucha / wzrost
inspirational - inspirujący (dający natchnienie)
preeminent - wybitny / dominujący / przewyższający innych
merely - zaledwie / jedynie / tylko
presumably - przypuszczalnie / prawdopodobnie
richly varied - mocno zróźnicowane
vivid - obrazowe / bujny / żywy
dimensionality - wymiarowość
taken in - przyjęte / przyswojone  / odbierane
intensities - intensywności / nasilenia / natężenia
pich - poziom / stopień / ton
quality - cecha / jakość / właściwość
commonplace - powszechny / pospolity
texture - tekstura / konsystencja - budowa wewnętrzna czegoś
stiff - zdrętwiały / sztywny / twardy
limber - giętki / zwinny
odor - woń / zapach / odór
incense - kadzidło
attend to - zająć się czymś
deliberately - umyślnie / celowo / powoli i wyraźnie
serenity - spokój / pogoda / łagodność
care to do something - mieć ochotę coś zrobić
aspect - aspekt / punkt widzenia / położenie
distinct - różny / odmienny / wyraźny / odrębny
mistic - mistyk - ktoś kto para się rzeczywistością pozamaterialną i pozazmysłową
ultimately - ostatecznie / finalnie / w końcu
adequately - odpowiednio / właściwie / adekwatnie
renewed - odnowiony
richness - bogactwo / przepych / wspaniałość
relate - odnosić się / dotyczyć / powiązać
experiential - oparty na doświadczeniach / empiryczny (poznanie za pomocą zmysłow)
originates - zapoczątkowywać / wymyślać / powstaje / rodzi się
perceive - odebrać w pewien sposób / postrzegać / zauważać
corresponds - odpowiadać / korespondować / mieć się do czegoś
perception - wyobrażenie / spostrzeżenie / rozumienie
independently - niezależnie / samodzielnie / osobno
relatively - relatywnie / stosunkowo / względnie
tend to - mieć tendencje / mieć skłonności
clarity - czystość / jasność / klarowność / przejrzystość
brilliance - błyskotliwość / jaskrawość / świetność
dumbfounded - oniemiały / zaskoczony
wonder - zastanawiać się / cud / zdumienie / zdziwienie
lucid - jasny / zrozumiały / przejrzysty / przytomny
exhilarating - ekscytujący / porywający
conceive - wyobrażać sobie / tworzyć / począć
thus - tak oto / stąd / w ten sposób / dlatego
deceased - nieboszczyk / zmarły / denat (samobójca / ofiara zabójstwa)
cultivating - uprawianie / doskonalenie / rozwijanie
enjoyment - przyjemność / radość
akin to - pokrewny do czegoś / zbliżony
indulging - pozwalanie sobie / dogadzanie sobie / dawanie upustu
set out for something - wyruszyć na coś
committing - deklarowanie się / powierzanie / anagażowania się / poświęcania się
recall - pamięć / przypomnienie sobie
peculiarities - szczególne cechy / osobliwości / dziwactwa
reliable - niezawodne / rzetelne / godne zaufania / solidne
applications - zastosowania / aplikacje / użycia
preliminary - wstępne / przygotowawcze
mystified - okryty tajemnicą / wprowadzony w zakłopotanie / zdziwieni
likely - prawdopodobnie / przypuszczalnie
mystery - tajemnica / zagadka
begs - prosić / błagać
wakefulness - czujność / jawa / bezsenność
exponents - przedstawiciele / propagatorzy
sensory - czuciowe / dotyczące organów zmysłu
synthesize - syntetyzować (łączyć w całość, przechodzić od szczegółów do uogólnień)
conception - koncepcja / pojęcie / rozumienie
whether - czy / azaliż
survival of the fittest - selekcja naturalna
engulf - pochłaniać / przytłaczać / ogarniać
ignorant - niewykształcony / ciemny / nieświadomy / prymitywny
gradually - stopniowo / powoli / sukcesywnie
sense organ - narząd zmysłu
bump - uderzyć / potrącić
sophisticated - wyrafinowany / zaawansowany / wyrobiony
correspondingly - odpowiednio / zgodnie
capacitities - zdolności
perceive - postrzegać / odbierać w pewien sposób
accomplish - osiągać / wykańczać / realizować
ordinarily - zazwyczaj / zwykle
straighforward - jasny / prosty / przystępny / prostolinijny
nontheless - niemniej / jednakże
mental - umysłowy / psychiczny
engaged - zajęty / wciągnięty
actively - aktywnie / czynnie
accurately - dokładnie / trafnie / wiernie
stimuli - bodziec / zachęta
wanders - wędrować / włóczyć się / szwendać się
daydream - sen na jawie / marzyć / fantazjować
rather - raczej / całkiem / dosyć
tend - mieć tendencje, mieć skłonności
merely - ledwie / jedynie / tylko
uniform - jednakowy / stały
withdrawal - odwołanie / odwrót / wycofanie / rezygnacja
distinguished - wyróżniający się / nieprzeciętny
scalp - skalp (skóra na czubku głowy)
muscle tone - jędrność mięśni
commonsense - zdroworozsądkowy
facilitating - udostępnianie / ułatwianie / umożliwanie
restorative - wzmacniający / pokrzepiający / środek wzmacniający
incidentally - nawiasem mówiąc / przypadkowo
transition - przemiana / przekształcenie / przejście
collapsed - zawalony / upadły / zarwany
tail wagging - machanie ogonem
whimpering - kwilenie / skomlenie / skowyt / jęki
justifiably - słusznie / nie bez powodu